888888888888888
800080000000008
800080000000008
800080000000008
900088888000088
800000008000008
800088888000008
800080000000008
800088888800008
800000000800008
800088888800008
800000000000008
800888888800008
800800000800008
888888888888888
