888888888988888
800000000000008
800088000008008
800088000000008
800000000080008
800000000000008
800088888000008
800080000000008
800088888800008
800000000000008
800880000000008
800880000000008
800000000800008
800880000800008
888888888888888
